################
################
################
###    ##    ###
###    ##    ###
###  ######  ###
###  ######  ###
################
################
###  ######  ###
###  ######  ###
###    ##    ###
###    ##    ###
################
################
################